"Name","Market.Value","Age","Nation","Team","MP","Min","X90s","Starts","Subs","unSub","Gls","Ast","G.A","G.PK","PK","PKatt","PKm","Pos","X.9999"
"William Saliba","€80.00m","22","France","Arsenal","38","3420","38.0","38","0","0","2","1","3","2","0","0","0","DF","972aeb2a"
"Gabriel Magalhães","€70.00m","25","Brazil","Arsenal","36","3044","33.8","34","2","2","4","0","4","4","0","0","0","DF","67ac5bb8"
"Jakub Kiwior","€30.00m","23","Poland","Arsenal","20","946","10.5","11","9","18","1","3","4","1","0","0","0","DF","dc3e663e"
"Oleksandr Zinchenko","€38.00m","26","Ukraine","Arsenal","27","1722","19.1","20","7","5","1","2","3","1","0","0","0","DF","51cf8561"
"Ben White","€55.00m","25","England","Arsenal","37","2988","33.2","35","2","0","4","4","8","4","0","0","0","DF","35e413f1"
"Takehiro Tomiyasu","€35.00m","24","Japan","Arsenal","22","1149","12.8","10","12","1","2","1","3","2","0","0","0","DF","b3af9be1"
"Cédric Soares","€2.00m","31","Portugal","Arsenal","3","62","0.7","0","3","15","0","0","0","0","0","0","0","DF","839c14e1"
"Declan Rice","€120.00m","24","England","Arsenal","38","3225","35.8","37","1","0","7","8","15","7","0","0","0","MF","1c7012b8"
"Thomas Partey","€18.00m","30","Ghana","Arsenal","14","788","8.8","9","5","3","0","0","0","0","0","0","0","MFDF","529f49ab"
"Jorginho","€12.00m","31","Italy","Arsenal","24","921","10.2","10","14","13","0","2","2","0","0","0","0","MF","45db685d"
"Mohamed Elneny","€3.50m","31","Egypt","Arsenal","3","28","0.3","0","3","13","0","0","0","0","0","0","0","MF","47a34c4f"
"Albert Sambi Lokonga","€15.00m","23","Belgium","Luton Town","17","1303","14.5","16","1","0","1","3","4","1","0","0","0","MF","1b4f1169"
"Martin Ødegaard","€110.00m","24","Norway","Arsenal","35","3091","34.3","35","0","1","8","10","18","6","2","2","0","MF","79300479"
"Emile Smith Rowe","€22.00m","23","England","Arsenal","13","353","3.9","3","10","18","0","1","1","0","0","0","0","MF","17695062"
"Ethan Nwaneri","€8.00m","16","England","Arsenal","1","14","0.2","0","1","1","0","0","0","0","0","0","0","FW","7f94982c"
"Gabriel Martinelli","€70.00m","22","Brazil","Arsenal","35","2019","22.4","24","11","0","6","4","10","6","0","0","0","FW","48a5a5d6"
"Leandro Trossard","€35.00m","28","Belgium","Arsenal","34","1649","18.3","18","16","3","12","1","13","12","0","0","0","FWMF","38ceb24a"
"Bukayo Saka","€140.00m","21","England","Arsenal","35","2919","32.4","35","0","0","16","9","25","10","6","6","0","FW","bc7dc64d"
"Reiss Nelson","€15.00m","23","England","Arsenal","15","268","3.0","1","14","15","0","0","0","0","0","0","0","FW","c5bdb6e3"
"Kai Havertz","€70.00m","24","Germany","Arsenal","37","2634","29.3","30","7","0","13","7","20","12","1","1","0","MFFW","fed7cb61"
"Gabriel Jesus","€65.00m","26","Brazil","Arsenal","27","1478","16.4","17","10","3","4","5","9","4","0","0","0","FW","b66315ae"
"Eddie Nketiah","€30.00m","24","England","Arsenal","27","1082","12.0","10","17","11","5","2","7","5","0","0","0","FW","a53649b7"
"Pau Torres","€45.00m","26","Spain","Aston Villa","29","2464","27.4","27","2","5","2","0","2","2","0","0","0","DF","532e1e4f"
"Ezri Konsa","€35.00m","25","England","Aston Villa","35","3069","34.1","35","0","0","1","0","1","1","0","0","0","DF","0313a347"
"Diego Carlos","€16.00m","30","Brazil","Aston Villa","27","1816","20.2","20","7","5","0","0","0","0","0","0","0","DF","b4a014b1"
"Tyrone Mings","€13.00m","30","England","Aston Villa","1","30","0.3","1","0","0","0","0","0","0","0","0","0","DF","8397a50c"
"Clément Lenglet","€10.00m","28","France","Aston Villa","14","1153","12.8","14","0","20","0","1","1","0","0","0","0","DF","4f28a6ff"
"Calum Chambers","€4.00m","28","England","Aston Villa","5","152","1.7","1","4","26","0","1","1","0","0","0","0","MFDF","dc6f5bdd"
"Finley Munroe","€100k","18","England","Aston Villa","1","4","0.0","0","1","2","0","0","0","0","0","0","0","MF","36625c27"
"Álex Moreno","€13.00m","30","Spain","Aston Villa","21","1031","11.5","11","10","4","2","0","2","2","0","0","0","DF","16e9d0ea"
"Lucas Digne","€12.00m","30","France","Aston Villa","33","2410","26.8","27","6","0","1","3","4","1","0","0","0","DF","1b84dbe1"
"Matty Cash","€28.00m","25","Poland","Aston Villa","29","2142","23.8","23","6","2","2","2","4","2","0","0","0","DF","2389cdc2"
"Kaine Kesler-Hayden","€2.20m","20","England","Aston Villa","3","6","0.1","0","3","14","0","0","0","0","0","0","0","MFDF","9b066938"
"Boubacar Kamara","€38.00m","23","France","Aston Villa","20","1652","18.4","20","0","0","0","1","1","0","0","0","0","MF","cc77354e"
"Leander Dendoncker","€7.00m","28","Belgium","Aston Villa","8","119","1.3","1","7","10","1","0","1","1","0","0","0","MF","5a7301ae"
"Douglas Luiz","€70.00m","25","Brazil","Aston Villa","35","2993","33.3","35","0","0","9","5","14","5","4","4","0","MF","6f7d826d"
"John McGinn","€30.00m","28","Scotland","Aston Villa","35","2999","33.3","35","0","0","6","4","10","6","0","0","0","MFFW","90f91999"
"Youri Tielemans","€25.00m","26","Belgium","Aston Villa","32","1622","18.0","17","15","0","2","6","8","2","0","0","0","MFFW","56f7a928"
"Tim Iroegbunam","€4.00m","20","England","Aston Villa","9","164","1.8","1","8","16","0","0","0","0","0","0","0","MF","84c5ceea"
"Jacob Ramsey","€35.00m","22","England","Aston Villa","16","853","9.5","8","8","0","1","1","2","1","0","0","0","FWMF","1544f145"
"Nicolò Zaniolo","€20.00m","24","Italy","Aston Villa","25","839","9.3","9","16","5","2","0","2","2","0","0","0","FWMF","9907b1c8"
"Morgan Rogers","€15.00m","21","England","Aston Villa","11","638","7.1","8","3","3","3","1","4","3","0","0","0","MFFW","2e5915f1"
"Philippe Coutinho","€7.50m","31","Brazil","Aston Villa","2","25","0.3","0","2","0","0","0","0","0","0","0","0","MFFW","0ef89a37"
"Omari Kellyman","€1.00m","17","England","Aston Villa","2","37","0.4","0","2","10","0","0","0","0","0","0","0","FW","aa888da7"
"Moussa Diaby","€55.00m","24","France","Aston Villa","38","2174","24.2","25","13","0","6","8","14","6","0","0","0","FWMF","aeed5c06"
"Leon Bailey","€42.00m","25","Jamaica","Aston Villa","35","2068","23.0","22","13","1","10","9","19","10","0","0","0","MFFW","3a233281"
"Bertrand Traoré","€9.00m","27","Burkina Faso","Aston Villa","2","11","0.1","0","2","6","0","0","0","0","0","0","0","DFFW","c47541e0"
"Ollie Watkins","€65.00m","27","England","Aston Villa","37","3217","35.7","37","0","0","19","13","32","19","0","0","0","FW","aed3a70f"
"Jhon Durán","€20.00m","19","Colombia","Aston Villa","23","475","5.3","3","20","5","5","0","5","5","0","0","0","FWMF","414184f7"
"Marcos Senesi","€22.00m","26","Argentina","Bournemouth","31","2242","24.9","26","5","1","4","5","9","4","0","0","0","DF","35141f4c"
"Lloyd Kelly","€18.00m","24","England","Bournemouth","23","1559","17.3","17","6","0","0","1","1","0","0","0","0","DF","f31def1e"
"Chris Mepham","€6.00m","25","Wales","Bournemouth","10","617","6.9","6","4","14","0","1","1","0","0","0","0","DF","fed96827"
"James Hill","€2.00m","21","England","Bournemouth","5","76","0.8","1","4","10","0","0","0","0","0","0","0","DF","69942fb3"
"Milos Kerkez","€20.00m","19","Hungary","Bournemouth","28","1970","21.9","22","6","3","0","1","1","0","0","0","0","DF","0ad53bdc"
"Max Aarons","€16.00m","23","England","Bournemouth","20","1237","13.7","13","7","5","0","1","1","0","0","0","0","DF","774cf58b"
"Adam Smith","€1.00m","32","England","Bournemouth","28","2150","23.9","25","3","6","0","2","2","0","0","0","0","DF","20b104bc"
"Tyler Adams","€15.00m","24","United States","Bournemouth","3","121","1.3","1","2","2","0","0","0","0","0","0","0","MF","2b09d998"
"Philip Billing","€22.00m","27","Denmark","Bournemouth","29","1398","15.5","13","16","4","2","2","4","2","0","0","0","MF","d328a254"
"Alex Scott","€20.00m","19","England","Bournemouth","23","1014","11.3","11","12","2","1","1","2","1","0","0","0","MF","104d0bb8"
"Lewis Cook","€12.00m","26","England","Bournemouth","33","2786","31.0","32","1","0","0","3","3","0","0","0","0","MF","2afc7272"
"Ryan Christie","€12.00m","28","Scotland","Bournemouth","37","2907","32.3","35","2","0","0","5","5","0","0","0","0","MF","26ce2263"
"Joe Rothwell","€2.50m","28","England","Bournemouth","11","386","4.3","3","8","8","0","0","0","0","0","0","0","MF","10a10454"
"Romain Faivre","€15.00m","25","France","Bournemouth","5","41","0.5","0","5","8","0","0","0","0","0","0","0","MFFW","745ca0a3"
"Marcus Tavernier","€20.00m","24","England","Bournemouth","30","2118","23.5","25","5","0","3","4","7","3","0","0","0","FW","5c0da4a4"
"Dango Ouattara","€20.00m","21","Burkina Faso","Bournemouth","30","1229","13.7","12","18","2","1","2","3","1","0","0","0","FWDF","2f9e4435"
"Luis Sinisterra","€17.00m","24","Colombia","Bournemouth","20","699","7.8","7","13","4","2","2","4","2","0","0","0","FWMF","8e16dd48"
"Justin Kluivert","€14.00m","24","Netherlands","Bournemouth","32","1916","21.3","26","6","6","7","1","8","7","0","0","0","MFFW","4c3a6744"
"Jaidon Anthony","€6.00m","23","England","Bournemouth","3","152","1.7","2","1","0","0","0","0","0","0","0","0","FW","e4238fb1"
"Antoine Semenyo","€10.00m","23","Ghana","Bournemouth","33","2105","23.4","25","8","3","8","2","10","8","0","0","0","FW","efd2ec23"
"David Brooks","€8.00m","26","Wales","Bournemouth","13","282","3.1","2","11","7","1","1","2","1","0","0","0","FWMF","dc4cae05"
"Dominic Sadi","€100k","19","England","Bournemouth","1","1","0.0","0","1","4","0","0","0","0","0","0","0","FW","54778940"
"Dominic Solanke","€40.00m","25","England","Bournemouth","38","3325","36.9","37","1","0","19","3","22","17","2","3","1","FW","e77dc3b2"
"Enes Ünal","€18.00m","26","Turkiye","Bournemouth","16","328","3.6","2","14","0","2","2","4","2","0","0","0","FWMF","f8eca1b6"
"Kieffer Moore","€2.00m","30","Wales","Bournemouth","8","108","1.2","0","8","8","1","0","1","1","0","0","0","FWMF","01ce9e70"
"Nathan Collins","€25.00m","22","Republic of Ireland","Brentford","32","2652","29.5","29","3","1","1","1","2","1","0","0","0","DF","a8c19eb8"
"Kristoffer Ajer","€15.00m","25","Norway","Brentford","28","1832","20.4","21","7","1","2","1","3","2","0","0","0","DF","a8c0acb7"
"Ethan Pinnock","€12.00m","30","Jamaica","Brentford","29","2521","28.0","28","1","0","2","0","2","2","0","0","0","DF","e541326e"
"Ben Mee","€1.00m","33","England","Brentford","16","1272","14.1","15","1","2","2","0","2","2","0","0","0","DF","8df7a2fb"
"Rico Henry","€20.00m","26","England","Brentford","5","401","4.5","5","0","0","0","1","1","0","0","0","0","DF","8a3c1dc7"
"Aaron Hickey","€28.00m","21","Scotland","Brentford","9","713","7.9","9","0","0","0","0","0","0","0","0","0","DF","1780bb4a"
"Mads Roerslev","€10.00m","24","Denmark","Brentford","34","1985","22.1","22","12","3","1","2","3","1","0","0","0","DF","57c94db2"
"Vitaly Janelt","€22.00m","25","Germany","Brentford","38","3054","33.9","37","1","0","1","3","4","1","0","0","0","MFDF","8449d35e"
"Christian Nørgaard","€18.00m","29","Denmark","Brentford","31","2505","27.8","30","1","0","2","1","3","2","0","0","0","MF","df0a4c90"
"Mathias Jensen","€28.00m","27","Denmark","Brentford","32","2204","24.5","27","5","0","3","3","6","3","0","0","0","MF","0f134faf"
"Josh Dasilva","€10.00m","24","England","Brentford","3","24","0.3","0","3","1","0","0","0","0","0","0","0","DFFW","60344e4f"
"Frank Onyeka","€9.00m","25","Nigeria","Brentford","26","1161","12.9","11","15","4","1","2","3","1","0","0","0","MF","2944f86f"
"Shandon Baptiste","€2.50m","25","Grenada","Brentford","10","229","2.5","2","8","11","1","1","2","1","0","0","0","MF","2886c9b5"
"Saman Ghoddos","€2.00m","29","Iran","Brentford","19","739","8.2","7","12","13","1","0","1","1","0","0","0","DF","f7b1d4e0"
"Myles Peart-Harris","€700k","20","England","Brentford","3","13","0.1","0","3","6","0","0","0","0","0","0","0","DFMF","ea1a5662"
"Kevin Schade","€22.00m","21","Germany","Brentford","11","333","3.7","3","8","0","2","1","3","2","0","0","0","FWMF","52afb588"
"Keane Lewis-Potter","€15.00m","22","England","Brentford","30","1441","16.0","15","15","3","3","1","4","3","0","0","0","FWDF","41f08ac8"
"Mikkel Damsgaard","€10.00m","23","Denmark","Brentford","23","842","9.4","7","16","3","0","2","2","0","0","0","0","MF","215f3907"
"Bryan Mbeumo","€40.00m","23","Cameroon","Brentford","25","1960","21.8","22","3","0","9","6","15","6","3","3","0","FW","6afaebf2"
"Michael Olakigbe","€600k","19","England","Brentford","8","59","0.7","0","8","9","0","0","0","0","0","0","0","DFFW","cdd70dc0"
"Ivan Toney","€50.00m","27","England","Brentford","17","1450","16.1","16","1","1","4","2","6","4","0","0","0","FW","e09f279b"
"Yoane Wissa","€28.00m","26","DR Congo","Brentford","34","2493","27.7","29","5","0","12","3","15","12","0","0","0","FW","2500cef9"
"Adam Webster","€20.00m","28","England","Brighton","15","1144","12.7","13","2","12","0","0","0","0","0","0","0","DF","c40b6180"
"Jan Paul van Hecke","€18.00m","23","Netherlands","Brighton","28","2369","26.3","26","2","4","0","0","0","0","0","0","0","DF","4fd08daa"
"Igor","€17.00m","25","Brazil","Brighton","24","1637","18.2","17","7","10","0","0","0","0","0","0","0","DF","a4e85758"
"Lewis Dunk","€12.00m","31","England","Brighton","33","2869","31.9","33","0","0","3","1","4","3","0","0","0","DF","282f75f3"
"Pervis Estupiñán","€30.00m","25","Ecuador","Brighton","19","1243","13.8","15","4","1","2","3","5","2","0","0","0","DF","d38fdf53"
"Valentín Barco","€13.00m","19","Argentina","Brighton","6","307","3.4","3","3","4","0","0","0","0","0","0","0","DFFW","b9f282ec"
"Tariq Lamptey","€12.00m","22","Ghana","Brighton","19","914","10.2","10","9","0","0","3","3","0","0","0","0","DFFW","f4e433d4"
"Joël Veltman","€10.00m","31","Netherlands","Brighton","27","1588","17.6","17","10","2","1","1","2","1","0","0","0","DF","dad4b285"
"Odeluga Offiah","€300k","20","England","Brighton","4","128","1.4","1","3","4","0","0","0","0","0","0","0","DF","65c3efa2"
"Carlos Baleba","€22.00m","19","Cameroon","Brighton","27","1325","14.7","15","12","7","0","0","0","0","0","0","0","MF","a1390d2f"
"Billy Gilmour","€18.00m","22","Scotland","Brighton","30","2120","23.6","24","6","1","0","1","1","0","0","0","0","MF","df10e27c"
"Jack Hinshelwood","€16.00m","18","England","Brighton","12","869","9.7","8","4","4","3","0","3","3","0","0","0","DF","e98211e7"
"Jakub Moder","€10.00m","24","Poland","Brighton","17","618","6.9","6","11","10","0","0","0","0","0","0","0","MFDF","f230bc30"
"Pascal Groß","€8.00m","32","Germany","Brighton","36","3114","34.6","34","2","0","4","10","14","3","1","1","0","MFDF","8aec0537"
"Mahmoud Dahoud","€6.00m","27","Germany","Brighton","9","452","5.0","6","3","8","0","1","1","0","0","0","0","MF","db4ed67b"
"James Milner","€1.00m","37","England","Brighton","15","773","8.6","11","4","2","0","2","2","0","0","0","0","DFMF","2f90f6b8"
"Julio Enciso","€22.00m","19","Paraguay","Brighton","12","475","5.3","5","7","1","0","2","2","0","0","0","0","MFFW","9cfbad36"
"Facundo Buonanotte","€18.00m","18","Argentina","Brighton","27","1364","15.2","17","10","6","3","1","4","3","0","0","0","FWMF","468a7a91"
"Adam Lallana","€1.00m","35","England","Brighton","25","850","9.4","13","12","8","0","1","1","0","0","0","0","MFFW","99813635"
"Kaoru Mitoma","€45.00m","26","Japan","Brighton","19","1486","16.5","15","4","0","3","4","7","3","0","0","0","FW","74618572"
"Ansu Fati","€25.00m","20","Spain","Brighton","19","521","5.8","3","16","5","2","0","2","2","0","0","0","MFFW","0ba976e4"
"Simon Adingra","€30.00m","21","Côte d'Ivoire","Brighton","31","2222","24.7","25","6","1","6","1","7","6","0","0","0","FW","4dcec659"
"Solly March","€18.00m","29","England","Brighton","7","554","6.2","7","0","1","3","1","4","3","0","0","0","FWDF","bb5fbd2b"
"Evan Ferguson","€50.00m","18","Republic of Ireland","Brighton","27","1367","15.2","15","12","1","6","0","6","6","0","0","0","FW","4596da74"
"João Pedro","€45.00m","21","Brazil","Brighton","31","2045","22.7","19","12","0","9","3","12","5","4","5","1","FWMF","e8832875"
"Danny Welbeck","€5.00m","32","England","Brighton","29","1693","18.8","21","8","1","5","1","6","5","0","0","0","FWMF","ce5143da"
"Mark O'Mahony","€300k","18","Republic of Ireland","Brighton","3","63","0.7","1","2","8","0","0","0","0","0","0","0","FW","a3afdd69"
"Levi Colwill","€50.00m","20","England","Chelsea","23","1797","20.0","20","3","4","1","1","2","1","0","0","0","DF","700783e7"
"Axel Disasi","€40.00m","25","France","Chelsea","31","2579","28.7","29","2","4","2","0","2","2","0","0","0","DF","ad82197c"
"Benoît Badiashile","€30.00m","22","France","Chelsea","18","1338","14.9","15","3","7","0","1","1","0","0","0","0","DF","06df8256"
"Trevoh Chalobah","€13.00m","24","England","Chelsea","13","952","10.6","10","3","1","1","0","1","1","0","0","0","DF","5515376c"
"Alfie Gilchrist","€5.00m","19","England","Chelsea","11","207","2.3","2","9","14","1","0","1","1","0","0","0","DF","d91f104d"
"Thiago Silva","€1.00m","38","Brazil","Chelsea","31","2527","28.1","28","3","5","3","1","4","3","0","0","0","DF","86e7deaf"
"Ian Maatsen","€40.00m","21","Netherlands","Chelsea","12","209","2.3","1","11","8","0","0","0","0","0","0","0","FWMF","cab9634e"
"Ben Chilwell","€28.00m","26","England","Chelsea","13","756","8.4","9","4","1","0","1","1","0","0","0","0","DF","d2424d1b"
"Marc Cucurella","€25.00m","25","Spain","Chelsea","21","1782","19.8","20","1","6","0","2","2","0","0","0","0","DF","1daec722"
"Reece James","€40.00m","23","England","Chelsea","10","419","4.7","5","5","0","0","2","2","0","0","0","0","DF","1265a93a"
"Malo Gusto","€35.00m","20","France","Chelsea","27","1751","19.5","19","8","1","0","6","6","0","0","0","0","DF","d56b9520"
"Moisés Caicedo","€75.00m","21","Ecuador","Chelsea","35","2866","31.8","33","2","0","1","3","4","1","0","0","0","MF","16264a81"
"Roméo Lavia","€35.00m","19","Belgium","Chelsea","1","33","0.4","0","1","1","0","0","0","0","0","0","0","MF","ecad9aa5"
"Lesley Ugochukwu","€25.00m","19","France","Chelsea","12","301","3.3","3","9","5","0","0","0","0","0","0","0","MF","1df4a109"
"Enzo Fernández","€75.00m","22","Argentina","Chelsea","28","2209","24.5","26","2","0","3","2","5","2","1","2","1","MF","5ff4ab71"
"Conor Gallagher","€50.00m","23","England","Chelsea","37","3128","34.8","37","0","0","5","7","12","5","0","0","0","MF","c2731c10"
"Carney Chukwuemeka","€15.00m","19","England","Chelsea","9","227","2.5","2","7","4","1","1","2","1","0","0","0","MFFW","b2f9c73e"
"Cesare Casadei","€10.00m","20","Italy","Chelsea","11","79","0.9","0","11","6","0","0","0","0","0","0","0","FWMF","fb920f3a"
"Alex Matos","€1.20m","18","England","Chelsea","1","1","0.0","0","1","12","0","0","0","0","0","0","0","MF","ed383e43"
"Jimi Tauriainen","€200k","19","England","Chelsea","1","1","0.0","0","1","4","0","0","0","0","0","0","0","FW","cac9e583"
"Christopher Nkunku","€65.00m","25","France","Chelsea","11","443","4.9","2","9","1","3","0","3","3","0","0","0","FWMF","7c56da38"
"Raheem Sterling","€35.00m","28","England","Chelsea","31","1978","22.0","22","9","3","8","4","12","8","0","0","0","FWMF","b400bde0"
"Noni Madueke","€28.00m","21","England","Chelsea","23","1053","11.7","13","10","10","5","2","7","4","1","1","0","FW","bf34eebd"
"Nicolas Jackson","€35.00m","22","Senegal","Chelsea","35","2799","31.1","31","4","0","14","5","19","14","0","0","0","FW","9c36ed83"
"David Datro Fofana","€12.00m","20","Côte d'Ivoire","Burnley","15","879","9.8","10","5","1","4","1","5","4","0","0","0","FW","e82900ef"
"Deivid Washington","€9.00m","18","Brazil","Chelsea","2","13","0.1","0","2","17","0","0","0","0","0","0","0","DFFW","95bd120d"
"Mason Burstow","€1.80m","19","England","Chelsea","2","9","0.1","0","2","1","0","0","0","0","0","0","0","FW","dab84ad2"
"Marc Guéhi","€38.00m","23","England","Crystal Palace","25","2021","22.5","23","2","0","0","1","1","0","0","0","0","DF","d0706b27"
"Joachim Andersen","€35.00m","27","Denmark","Crystal Palace","38","3415","37.9","38","0","0","2","3","5","2","0","0","0","DF","e34fc66d"
"Chris Richards","€12.00m","23","United States","Crystal Palace","26","2094","23.3","23","3","9","1","1","2","1","0","0","0","DFMF","0a3d6d2b"
"James Tomkins","€700k","34","England","Crystal Palace","4","10","0.1","0","4","24","0","0","0","0","0","0","0","DF","e7ca0439"
"Tyrick Mitchell","€25.00m","23","England","Crystal Palace","37","3204","35.6","37","0","0","2","3","5","2","0","0","0","DFMF","5cbd1eb0"
"Daniel Muñoz","€18.00m","27","Colombia","Crystal Palace","16","1439","16.0","16","0","0","0","4","4","0","0","0","0","DFMF","778ef829"
"Nathaniel Clyne","€1.50m","32","England","Crystal Palace","19","1338","14.9","14","5","18","0","0","0","0","0","0","0","DF","0442183b"
"Joel Ward","€1.00m","33","England","Crystal Palace","26","1980","22.0","23","3","5","0","1","1","0","0","0","0","DF","8a7ff278"
"Cheick Doucouré","€35.00m","23","Mali","Crystal Palace","11","919","10.2","11","0","1","0","0","0","0","0","0","0","MF","ce4f40c7"
"Adam Wharton","€30.00m","19","England","Crystal Palace","16","1297","14.4","15","1","0","0","3","3","0","0","0","0","MF","4b542852"
"Jefferson Lerma","€20.00m","28","Colombia","Crystal Palace","28","2400","26.7","27","1","0","1","1","2","1","0","0","0","MFDF","9b5ce51a"
"David Ozoh","€700k","18","England","Crystal Palace","9","156","1.7","0","9","15","0","0","0","0","0","0","0","MFDF","d00d45ab"
"Will Hughes","€9.00m","28","England","Crystal Palace","30","1891","21.0","23","7","1","0","1","1","0","0","0","0","MF","a0666d3e"
"Naouirou Ahamada","€8.00m","21","France","Crystal Palace","20","349","3.9","0","20","14","0","0","0","0","0","0","0","MFFW","a6c58494"
"Jeffrey Schlupp","€7.00m","30","Ghana","Crystal Palace","29","1352","15.0","17","12","3","2","2","4","2","0","0","0","FWMF","3312f911"
"Eberechi Eze","€55.00m","25","England","Crystal Palace","27","2055","22.8","24","3","0","11","4","15","10","1","1","0","MFFW","ae4fc6a4"
"Matheus França","€15.00m","19","Brazil","Crystal Palace","10","232","2.6","1","9","9","0","1","1","0","0","0","0","MFFW","077faf72"
"Michael Olise","€55.00m","21","France","Crystal Palace","19","1275","14.2","14","5","0","10","6","16","9","1","1","0","FWMF","c4486bac"
"Jean-Philippe Mateta","€20.00m","26","France","Crystal Palace","35","2282","25.4","25","10","2","16","5","21","14","2","2","0","FW","50e6dc35"
"Jordan Ayew","€4.00m","31","Ghana","Crystal Palace","35","2543","28.3","30","5","1","4","7","11","4","0","0","0","FWMF","da052c14"
"Jarrad Branthwaite","€42.00m","21","England","Everton","35","3116","34.6","35","0","2","3","0","3","3","0","0","0","DF","c1949191"
"James Tarkowski","€13.00m","30","England","Everton","38","3419","38.0","38","0","0","1","1","2","1","0","0","0","DF","15ea812b"
"Ben Godfrey","€10.00m","25","England","Everton","15","1120","12.4","13","2","23","0","0","0","0","0","0","0","DF","9f7c837d"
"Michael Keane","€6.00m","30","England","Everton","9","439","4.9","4","5","26","1","0","1","1","0","0","0","DF","c5b7c315"
"Mason Holgate","€5.00m","26","England","Sheffield Utd","10","710","7.9","9","1","2","0","0","0","0","0","0","0","DF","d0042ab9"
"Vitaliy Mykolenko","€28.00m","24","Ukraine","Everton","28","2469","27.4","28","0","4","2","0","2","2","0","0","0","DF","30d4a2e5"
"Ashley Young","€500k","38","England","Everton","31","2280","25.3","27","4","1","0","0","0","0","0","0","0","DFMF","be927d03"
"Nathan Patterson","€15.00m","21","Scotland","Everton","20","1005","11.2","9","11","12","0","2","2","0","0","0","0","DF","230f0471"
"Séamus Coleman","€500k","34","Republic of Ireland","Everton","12","665","7.4","7","5","6","0","0","0","0","0","0","0","DF","0420d84f"
"Amadou Onana","€50.00m","21","Belgium","Everton","30","2091","23.2","23","7","1","2","0","2","2","0","0","0","MF","828657ff"
"James Garner","€22.00m","22","England","Everton","37","3004","33.4","34","3","0","1","2","3","1","0","0","0","MF","4e015693"
"Abdoulaye Doucouré","€10.00m","30","Mali","Everton","32","2629","29.2","32","0","0","7","1","8","7","0","0","0","FWMF","02b29014"
"André Gomes","€10.00m","30","Portugal","Everton","12","508","5.6","3","9","4","1","0","1","1","0","0","0","MFFW","1961b2aa"
"Lewis Warrington","€500k","20","England","Everton","1","1","0.0","0","1","7","0","0","0","0","0","0","0","FW","8e633970"
"Tyler Onyango","€500k","20","England","Everton","1","1","0.0","0","1","4","0","0","0","0","0","0","0","MF","d86a1f3e"
"Dwight McNeil","€22.00m","23","England","Everton","35","2892","32.1","33","2","0","3","6","9","3","0","0","0","MFFW","fc15fb84"
"Arnaut Danjuma","€13.00m","26","Netherlands","Everton","14","595","6.6","5","9","14","1","0","1","1","0","0","0","MFFW","f08490a6"
"Lewis Dobbin","€2.50m","20","England","Everton","12","232","2.6","1","11","16","1","0","1","1","0","0","0","MF","e814e1cf"
"Jack Harrison","€18.00m","26","England","Everton","29","2214","24.6","25","4","1","3","3","6","3","0","0","0","MFFW","aa849a12"
"Dominic Calvert-Lewin","€22.00m","26","England","Everton","32","2171","24.1","26","6","0","7","2","9","5","2","2","0","FW","59e6e5bf"
"Beto","€20.00m","25","Guinea-Bissau","Everton","30","951","10.6","9","21","2","3","0","3","3","0","1","1","FW","ed5c0319"
"Tosin Adarabioyo","€20.00m","25","England","Fulham","20","1617","18.0","18","2","2","2","0","2","2","0","0","0","DF","c81d773d"
"Issa Diop","€20.00m","26","France","Fulham","18","1424","15.8","16","2","3","0","0","0","0","0","0","0","DF","a712ca2b"
"Calvin Bassey","€16.00m","23","Nigeria","Fulham","29","2303","25.6","25","4","4","1","0","1","1","0","0","0","DF","a36524bf"
"Tim Ream","€800k","35","United States","Fulham","18","1503","16.7","17","1","13","1","0","1","1","0","0","0","DF","28b40c9c"
"Antonee Robinson","€25.00m","25","United States","Fulham","37","3265","36.3","37","0","0","0","6","6","0","0","0","0","DF","289601e6"
"Fodé Ballo-Touré","€3.00m","26","Senegal","Fulham","6","71","0.8","0","6","16","0","0","0","0","0","0","0","DFMF","f449640d"
"Timothy Castagne","€17.00m","27","Belgium","Fulham","34","2634","29.3","29","5","1","1","3","4","1","0","0","0","DF","197640fd"
"Kenny Tete","€15.00m","27","Netherlands","Fulham","14","867","9.6","10","4","14","1","0","1","1","0","0","0","DF","77d7c96f"
"João Palhinha","€55.00m","28","Portugal","Fulham","33","2699","30.0","31","2","0","4","1","5","4","0","0","0","MF","a78ff07f"
"Harrison Reed","€15.00m","28","England","Fulham","27","1325","14.7","15","12","10","0","2","2","0","0","0","0","MF","803ae100"
"Saša Lukić","€10.00m","26","Serbia","Fulham","24","1122","12.5","13","11","9","1","0","1","1","0","0","0","MF","c6e8cf1f"
"Tom Cairney","€2.00m","32","Scotland","Fulham","34","1488","16.5","14","20","4","1","4","5","1","0","0","0","MF","a8748947"
"Andreas Pereira","€20.00m","27","Brazil","Fulham","37","2613","29.0","34","3","1","3","7","10","3","0","0","0","MF","6639e500"
"Luke Harris","€1.00m","18","Wales","Fulham","1","75","0.8","0","1","4","0","0","0","0","0","0","0","MF","8c3078cd"
"Willian","€3.00m","34","Brazil","Fulham","31","2053","22.8","24","7","2","4","2","6","2","2","2","0","FW","8b9ebd03"
"Harry Wilson","€17.00m","26","Wales","Fulham","35","1620","18.0","16","19","1","4","6","10","4","0","0","0","FW","c6dc9ecd"
"Adama Traoré","€9.00m","27","Spain","Fulham","17","377","4.2","1","16","2","2","3","5","2","0","0","0","FWMF","9a28eba4"
"Aleksandar Mitrović","€28.00m","28","Serbia","Fulham","1","33","0.4","0","1","0","0","0","0","0","0","0","0","FW","3925dbd6"
"Rodrigo Muniz","€20.00m","22","Brazil","Fulham","26","1593","17.7","18","8","7","9","1","10","9","0","0","0","FW","a755db8c"
"Raúl Jiménez","€5.00m","32","Mexico","Fulham","24","1395","15.5","18","6","5","7","0","7","7","0","0","0","FW","b561db50"
"Carlos Vinícius","€4.00m","28","Brazil","Fulham","13","315","3.5","2","11","7","2","0","2","2","0","0","0","FW","8b529245"
"Ibrahima Konaté","€45.00m","24","France","Liverpool","22","1574","17.5","17","5","11","0","0","0","0","0","0","0","DF","5ed9b537"
"Virgil van Dijk","€30.00m","32","Netherlands","Liverpool","36","3177","35.3","36","0","0","2","2","4","2","0","0","0","DF","e06683ca"
"Joe Gomez","€28.00m","26","England","Liverpool","32","1786","19.8","17","15","4","0","1","1","0","0","0","0","DF","7a11550b"
"Jarell Quansah","€22.00m","20","England","Liverpool","17","1190","13.2","13","4","17","2","0","2","2","0","0","0","DF","4125cb98"
"Andrew Robertson","€30.00m","29","Scotland","Liverpool","23","1693","18.8","18","5","0","3","2","5","3","0","0","0","DF","2e4f5f03"
"Owen Beck","€1.25m","20","Wales","Liverpool","1","8","0.1","0","1","0","0","0","0","0","0","0","0","DF","a011a1e9"
"Trent Alexander-Arnold","€70.00m","24","England","Liverpool","28","2155","23.9","25","3","0","3","4","7","3","0","0","0","DF","cd1acf9d"
"Conor Bradley","€15.00m","20","Northern Ireland","Liverpool","11","753","8.4","10","1","8","1","3","4","1","0","0","0","DF","bbd67769"
"Wataru Endo","€13.00m","30","Japan","Liverpool","29","1722","19.1","20","9","4","1","0","1","1","0","0","0","MF","c149016b"
"Stefan Bajcetic","€11.00m","18","Spain","Liverpool","1","26","0.3","0","1","6","0","0","0","0","0","0","0","MF","32e8417f"
"Alexis Mac Allister","€75.00m","24","Argentina","Liverpool","33","2599","28.9","31","2","0","5","5","10","4","1","1","0","MF","83d074ff"
"Curtis Jones","€35.00m","22","England","Liverpool","23","1167","13.0","14","9","4","1","1","2","1","0","0","0","MF","4fb9c88f"
"Harvey Elliott","€35.00m","20","England","Liverpool","34","1352","15.0","11","23","4","3","6","9","3","0","0","0","MFFW","b9e1436c"
"Ryan Gravenberch","€35.00m","21","Netherlands","Liverpool","26","1121","12.5","12","14","5","1","0","1","1","0","0","0","MF","b8e740fb"
"Thiago Alcántara","€10.00m","32","Spain","Liverpool","1","6","0.1","0","1","0","0","0","0","0","0","0","0","MF","77e84962"
"Bobby Clark","€1.00m","18","England","Liverpool","5","89","1.0","1","4","6","0","0","0","0","0","0","0","MF","73341ace"
"James McConnell","€500k","18","England","Liverpool","3","4","0.0","0","3","15","0","0","0","0","0","0","0","MF","bf973eeb"
"Dominik Szoboszlai","€75.00m","22","Hungary","Liverpool","33","2104","23.4","25","8","0","3","2","5","3","0","0","0","MF","934e1968"
"Luis Díaz","€75.00m","26","Colombia","Liverpool","37","2629","29.2","32","5","0","8","5","13","8","0","0","0","FW","4a1a9578"
"Cody Gakpo","€50.00m","24","Netherlands","Liverpool","35","1649","18.3","17","18","0","8","5","13","8","0","0","0","FWMF","1971591f"
"Mohamed Salah","€55.00m","31","Egypt","Liverpool","32","2534","28.2","28","4","0","18","10","28","13","5","7","2","FW","e342ad68"
"Ben Doak","€10.00m","17","Scotland","Liverpool","1","14","0.2","0","1","8","0","0","0","0","0","0","0","FW","733f1a7d"
"Kaide Gordon","€1.20m","18","England","Liverpool","1","1","0.0","0","1","1","0","0","0","0","0","0","0","FW","19a9cb70"
"Darwin Núñez","€70.00m","24","Uruguay","Liverpool","36","2047","22.7","22","14","1","11","8","19","11","0","1","1","FW","4d77b365"
"Diogo Jota","€50.00m","26","Portugal","Liverpool","21","1145","12.7","14","7","1","10","3","13","10","0","0","0","FW","178ae8f8"
"Jayden Danns","€1.00m","17","England","Liverpool","2","9","0.1","0","2","4","0","0","0","0","0","0","0","FW","003cf4d1"
"Rúben Dias","€80.00m","26","Portugal","Manchester City","30","2559","28.4","28","2","5","0","0","0","0","0","0","0","DF","31c69ef1"
"Manuel Akanji","€45.00m","28","Switzerland","Manchester City","30","2511","27.9","28","2","4","2","0","2","2","0","0","0","DFMF","89ac64a6"
"Nathan Aké","€40.00m","28","Netherlands","Manchester City","29","2042","22.7","24","5","6","2","2","4","2","0","0","0","DF","eaeca114"
"John Stones","€38.00m","29","England","Manchester City","16","1064","11.8","12","4","11","1","0","1","1","0","0","0","DFMF","5eecec3d"
"Aymeric Laporte","€20.00m","29","Spain","Manchester City","1","12","0.1","0","1","0","0","0","0","0","0","0","0","DF","119b9a8e"
"Rico Lewis","€38.00m","18","England","Manchester City","16","809","9.0","8","8","22","2","0","2","2","0","0","0","DFMF","b57e066e"
"Kyle Walker","€13.00m","33","England","Manchester City","32","2767","30.7","30","2","3","0","4","4","0","0","0","0","DF","86dd77d1"
"Issa Kaboré","€10.00m","22","Burkina Faso","Luton Town","24","1729","19.2","21","3","4","0","2","2","0","0","0","0","DF","c066d1a5"
"Rodri","€120.00m","27","Spain","Manchester City","34","2931","32.6","34","0","1","8","9","17","8","0","0","0","MF","6434f10d"
"Bernardo Silva","€70.00m","28","Portugal","Manchester City","33","2578","28.6","29","4","2","6","9","15","6","0","0","0","MFFW","3eb22ec9"
"Kevin De Bruyne","€50.00m","32","Belgium","Manchester City","18","1221","13.6","15","3","3","4","10","14","4","0","0","0","MF","e46012d4"
"Jack Grealish","€60.00m","27","England","Manchester City","20","1009","11.2","10","10","9","3","1","4","3","0","0","0","FWMF","b0b4fd3e"
"Phil Foden","€150.00m","23","England","Manchester City","35","2857","31.7","33","2","2","19","8","27","19","0","0","0","FWMF","ed1e53f3"
"Oscar Bobb","€25.00m","20","Norway","Manchester City","14","302","3.4","2","12","21","1","1","2","1","0","0","0","FWMF","eed2427e"
"Sergio Gómez","€10.00m","22","Spain","Manchester City","6","53","0.6","0","6","26","0","1","1","0","0","0","0","FWMF","01e5f06e"
"Erling Haaland","€180.00m","23","Norway","Manchester City","31","2552","28.4","29","2","1","27","5","32","20","7","8","1","FW","1f44ac21"
"Lisandro Martínez","€45.00m","25","Argentina","Manchester Utd","11","646","7.2","8","3","0","0","1","1","0","0","0","0","DF","bac46a10"
"Raphaël Varane","€20.00m","30","France","Manchester Utd","22","1375","15.3","16","6","4","1","0","1","1","0","0","0","DF","9f8e9423"
"Harry Maguire","€18.00m","30","England","Manchester Utd","22","1653","18.4","18","4","3","2","2","4","2","0","0","0","DF","d8931174"
"Victor Lindelöf","€15.00m","29","Sweden","Manchester Utd","19","1328","14.8","14","5","2","1","1","2","1","0","0","0","DF","f5deef4c"
"Willy Kambwala","€5.00m","18","France","Manchester Utd","8","330","3.7","3","5","8","0","0","0","0","0","0","0","DF","6a7353d7"
"Jonny Evans","€2.00m","35","Northern Ireland","Manchester Utd","23","1392","15.5","15","8","3","0","1","1","0","0","0","0","DF","f8fcd2a5"
"Luke Shaw","€32.00m","28","England","Manchester Utd","12","959","10.7","12","0","0","0","0","0","0","0","0","0","DF","9c94165b"
"Diogo Dalot","€35.00m","24","Portugal","Manchester Utd","36","3174","35.3","35","1","1","2","3","5","2","0","0","0","DF","d9565625"
"Aaron Wan-Bissaka","€20.00m","25","England","Manchester Utd","22","1780","19.8","20","2","3","0","2","2","0","0","0","0","DF","9e525177"
"Sofyan Amrabat","€22.00m","26","Morocco","Manchester Utd","21","938","10.4","10","11","8","0","0","0","0","0","0","0","MFDF","5a2cb25d"
"Casemiro","€20.00m","31","Brazil","Manchester Utd","25","1982","22.0","24","1","1","1","2","3","1","0","0","0","MFDF","4d224fe8"
"Kobbie Mainoo","€50.00m","18","England","Manchester Utd","24","1924","21.4","24","0","5","3","1","4","3","0","0","0","MF","c6220452"
"Scott McTominay","€32.00m","26","Scotland","Manchester Utd","32","1901","21.1","18","14","2","7","1","8","7","0","0","0","MFFW","d93c2511"
"Christian Eriksen","€8.00m","31","Denmark","Manchester Utd","22","1141","12.7","12","10","11","1","2","3","1","0","0","0","MF","980522ec"
"Donny van de Beek","€5.00m","26","Netherlands","Manchester Utd","1","3","0.0","0","1","11","0","0","0","0","0","0","0","DF","50dc94ce"
"Daniel Gore","€900k","18","England","Manchester Utd","1","1","0.0","0","1","6","0","0","0","0","0","0","0","MF","861e9b3b"
"Bruno Fernandes","€70.00m","28","Portugal","Manchester Utd","35","3118","34.6","35","0","0","10","8","18","6","4","5","1","MFFW","507c7bdf"
"Mason Mount","€35.00m","24","England","Manchester Utd","14","516","5.7","5","9","0","1","0","1","1","0","0","0","MFFW","9674002f"
"Marcus Rashford","€60.00m","25","England","Manchester Utd","33","2271","25.2","26","7","0","7","2","9","5","2","2","0","FW","a1d5bd30"
"Alejandro Garnacho","€45.00m","19","Argentina","Manchester Utd","36","2565","28.5","30","6","2","7","4","11","7","0","0","0","FW","7aa8adfe"
"Jadon Sancho","€30.00m","23","England","Manchester Utd","3","79","0.9","0","3","0","0","0","0","0","0","0","0","FWMF","dbf053da"
"Antony","€25.00m","23","Brazil","Manchester Utd","29","1324","14.7","15","14","4","1","1","2","1","0","0","0","FW","99127249"
"Amad Diallo","€18.00m","21","Côte d'Ivoire","Manchester Utd","9","390","4.3","3","6","8","1","1","2","1","0","0","0","FWMF","9dc96f10"
"Facundo Pellistri","€8.00m","21","Uruguay","Manchester Utd","9","172","1.9","1","8","11","0","1","1","0","0","0","0","FWMF","ac7e7b1c"
"Omari Forson","€2.00m","19","England","Manchester Utd","4","70","0.8","1","3","9","0","1","1","0","0","0","0","FW","1b9728b0"
"Rasmus Højlund","€65.00m","20","Denmark","Manchester Utd","30","2158","24.0","25","5","0","10","2","12","10","0","0","0","FW","491a433d"
"Anthony Martial","€10.00m","27","France","Manchester Utd","13","448","5.0","5","8","3","1","0","1","1","0","0","0","FW","8b788c01"
"Sven Botman","€45.00m","23","Netherlands","Newcastle Utd","17","1377","15.3","15","2","0","2","2","4","2","0","0","0","DF","ccce7025"
"Fabian Schär","€10.00m","31","Switzerland","Newcastle Utd","36","3054","33.9","35","1","0","4","1","5","4","0","0","0","DF","c8aa95da"
"Dan Burn","€8.00m","31","England","Newcastle Utd","33","2726","30.3","32","1","0","2","2","4","2","0","0","0","DF","b2d31e83"
"Jamaal Lascelles","€7.00m","29","England","Newcastle Utd","16","1080","12.0","13","3","10","1","0","1","1","0","0","0","DF","450ab6fc"
"Lewis Hall","€18.00m","18","England","Newcastle Utd","18","781","8.7","8","10","15","1","0","1","1","0","0","0","DF","da011f18"
"Matt Targett","€10.00m","27","England","Newcastle Utd","3","78","0.9","1","2","8","0","0","0","0","0","0","0","DF","e514ab62"
"Paul Dummett","€900k","31","Wales","Newcastle Utd","5","20","0.2","0","5","24","0","0","0","0","0","0","0","DF","3fe6bd8c"
"Alex Murphy","€250k","19","Republic of Ireland","Newcastle Utd","2","13","0.1","0","2","17","0","0","0","0","0","0","0","DFFW","f1c42eb3"
"Kieran Trippier","€10.00m","32","England","Newcastle Utd","28","2236","24.8","26","2","0","1","10","11","1","0","0","0","DF","21512407"
"Emil Krafth","€2.50m","28","Sweden","Newcastle Utd","17","913","10.1","8","9","11","0","0","0","0","0","0","0","DF","77cf6852"
"Bruno Guimarães","€85.00m","25","Brazil","Newcastle Utd","37","3263","36.3","37","0","0","7","8","15","7","0","0","0","MF","82518f62"
"Joelinton","€40.00m","26","Brazil","Newcastle Utd","20","1279","14.2","15","5","0","2","1","3","2","0","0","0","MFFW","c17bfb65"
"Sandro Tonali","€38.00m","23","Italy","Newcastle Utd","8","438","4.9","5","3","1","1","0","1","1","0","0","0","MF","0db169ae"
"Joe Willock","€30.00m","23","England","Newcastle Utd","9","419","4.7","5","4","0","1","0","1","1","0","0","0","MF","a3b03921"
"Sean Longstaff","€25.00m","25","England","Newcastle Utd","35","2747","30.5","30","5","0","6","2","8","6","0","0","0","MF","a2b105e0"
"Lewis Miley","€22.00m","17","England","Newcastle Utd","17","1202","13.4","14","3","1","1","3","4","1","0","0","0","MF","2c6835e5"
"Elliot Anderson","€15.00m","20","England","Newcastle Utd","21","1027","11.4","10","11","0","0","2","2","0","0","0","0","MFFW","de31038e"
"Matt Ritchie","€1.00m","33","Scotland","Newcastle Utd","13","128","1.4","0","13","18","1","0","1","1","0","0","0","FWMF","71ef519e"
"Joe White","€300k","20","England","Newcastle Utd","4","13","0.1","0","4","10","0","0","0","0","0","0","0","MF","d60c03a9"
"Anthony Gordon","€60.00m","22","England","Newcastle Utd","35","2890","32.1","34","1","0","11","10","21","10","1","1","0","FW","2bd83368"
"Harvey Barnes","€35.00m","25","England","Newcastle Utd","21","802","8.9","7","14","0","5","3","8","5","0","0","0","FWMF","3ea50f67"
"Amadou Diallo","€400k","20","England","Newcastle Utd","1","1","0.0","0","1","5","0","0","0","0","0","0","0","MF","e31708b2"
"Miguel Almirón","€20.00m","29","Paraguay","Newcastle Utd","33","1937","21.5","23","10","0","3","1","4","3","0","0","0","FW","862a1c15"
"Jacob Murphy","€15.00m","28","England","Newcastle Utd","21","1189","13.2","14","7","5","3","7","10","3","0","0","0","FWDF","de112b84"
"Ben Parkinson","€250k","18","England","Newcastle Utd","1","25","0.3","0","1","8","0","0","0","0","0","0","0","FW","32163807"
"Alexander Isak","€75.00m","23","Sweden","Newcastle Utd","30","2255","25.1","27","3","1","21","2","23","16","5","6","1","FW","8e92be30"
"Callum Wilson","€13.00m","31","England","Newcastle Utd","20","991","11.0","9","11","0","9","1","10","7","2","2","0","FW","c596fcb0"
"Murillo","€35.00m","21","Brazil","Nott'ham Forest","32","2789","31.0","32","0","0","0","2","2","0","0","0","0","DF","1704b0b8"
"Andrew Omobamidele","€11.00m","21","Republic of Ireland","Nott'ham Forest","11","783","8.7","8","3","8","0","0","0","0","0","0","0","DF","c393a6c4"
"Scott McKenna","€9.00m","26","Scotland","Nott'ham Forest","5","416","4.6","5","0","1","0","0","0","0","0","0","0","DF","4e5a4cbc"
"Joe Worrall","€7.50m","26","England","Nott'ham Forest","7","439","4.9","5","2","7","0","0","0","0","0","0","0","DF","a5212312"
"Willy Boly","€2.50m","32","Côte d'Ivoire","Nott'ham Forest","20","1438","16.0","18","2","3","2","1","3","2","0","0","0","DF","a4ac4b8f"
"Felipe","€1.50m","34","Brazil","Nott'ham Forest","7","375","4.2","4","3","5","0","0","0","0","0","0","0","DF","51a3c4c8"
"Nuno Tavares","€15.00m","23","Portugal","Nott'ham Forest","8","457","5.1","5","3","5","0","0","0","0","0","0","0","DF","a65c844b"
"Harry Toffolo","€5.00m","27","England","Nott'ham Forest","23","1459","16.2","15","8","9","1","3","4","1","0","0","0","DF","a105d46a"
"Neco Williams","€17.00m","22","Wales","Nott'ham Forest","26","1637","18.2","18","8","5","0","1","1","0","0","0","0","DF","dd323728"
"Ola Aina","€12.00m","26","Nigeria","Nott'ham Forest","22","1692","18.8","20","2","3","1","1","2","1","0","0","0","DF","246d153b"
"Gonzalo Montiel","€10.00m","26","Argentina","Nott'ham Forest","14","801","8.9","8","6","10","0","2","2","0","0","0","0","DF","374d5158"
"Serge Aurier","€3.70m","30","Côte d'Ivoire","Nott'ham Forest","12","833","9.3","10","2","1","0","2","2","0","0","0","0","DFMF","5c2b4f07"
"Ibrahim Sangaré","€30.00m","25","Côte d'Ivoire","Nott'ham Forest","17","1035","11.5","13","4","7","0","0","0","0","0","0","0","MF","bced0375"
"Danilo","€28.00m","22","Brazil","Nott'ham Forest","29","1792","19.9","20","9","2","2","2","4","2","0","0","0","MF","a816dbfb"
"Orel Mangala","€20.00m","25","Belgium","Nott'ham Forest","20","1563","17.4","19","1","1","1","0","1","1","0","0","0","MF","a572e291"
"Cheikhou Kouyaté","€1.00m","33","Senegal","Nott'ham Forest","12","212","2.4","2","10","18","0","0","0","0","0","0","0","MF","8d3c902d"
"Nicolás Domínguez","€17.00m","25","Argentina","Nott'ham Forest","26","1495","16.6","19","7","6","2","2","4","2","0","0","0","MFFW","20b3a502"
"Ryan Yates","€12.00m","25","England","Nott'ham Forest","35","1992","22.1","21","14","2","1","1","2","1","0","0","0","MF","c1fe2a48"
"Morgan Gibbs-White","€40.00m","23","England","Nott'ham Forest","37","3156","35.1","35","2","0","5","10","15","4","1","1","0","MFFW","32f60ed8"
"Brandon Aguilera","€300k","20","Costa Rica","Nott'ham Forest","1","5","0.1","0","1","3","0","0","0","0","0","0","0","FW","938fa024"
"Callum Hudson-Odoi","€18.00m","22","England","Nott'ham Forest","29","1854","20.6","20","9","1","8","1","9","8","0","0","0","FWMF","15f3ec41"
"Anthony Elanga","€22.00m","21","Sweden","Nott'ham Forest","36","2433","27.0","25","11","0","5","9","14","5","0","0","0","FWMF","2fba6108"
"Taiwo Awoniyi","€28.00m","25","Nigeria","Nott'ham Forest","20","1042","11.6","12","8","0","6","3","9","6","0","0","0","FW","e5478b87"
"Chris Wood","€7.00m","31","New Zealand","Nott'ham Forest","31","1812","20.1","20","11","0","14","1","15","14","0","0","0","FW","4e9a0555"
"Divock Origi","€5.00m","28","Belgium","Nott'ham Forest","20","606","6.7","6","14","7","0","1","1","0","0","0","0","FW","43a166b4"
"Rodrigo Ribeiro","€3.00m","18","Portugal","Nott'ham Forest","4","17","0.2","0","4","8","0","0","0","0","0","0","0","MFFW","484a3eae"
"Cristian Romero","€60.00m","25","Argentina","Tottenham","33","2790","31.0","33","0","0","5","0","5","5","0","0","0","DF","a3d94a58"
"Micky van de Ven","€55.00m","22","Netherlands","Tottenham","27","2339","26.0","27","0","1","3","0","3","3","0","0","0","DF","8fe2a392"
"Radu Drăgușin","€25.00m","21","Romania","Tottenham","9","429","4.8","4","5","9","0","0","0","0","0","0","0","DF","620922ed"
"Davinson Sánchez","€17.00m","27","Colombia","Tottenham","1","77","0.9","0","1","3","0","0","0","0","0","0","0","DF","da7b447d"
"Eric Dier","€12.00m","29","England","Tottenham","4","201","2.2","1","3","8","0","0","0","0","0","0","0","DF","ac861941"
"Ben Davies","€10.00m","30","Wales","Tottenham","17","1090","12.1","12","5","13","1","0","1","1","0","0","0","DF","44781702"
"Destiny Udogie","€45.00m","20","Italy","Tottenham","28","2391","26.6","28","0","0","2","3","5","2","0","0","0","DF","7cd520e8"
"Pedro Porro","€45.00m","23","Spain","Tottenham","35","3089","34.3","35","0","1","3","7","10","3","0","0","0","DF","27d0a506"
"Yves Bissouma","€35.00m","26","Mali","Tottenham","28","2068","23.0","26","2","0","0","0","0","0","0","0","0","MF","6c203af0"
"Rodrigo Bentancur","€35.00m","26","Uruguay","Tottenham","23","1005","11.2","13","10","0","1","1","2","1","0","0","0","MF","3b8674e6"
"Oliver Skipp","€15.00m","22","England","Tottenham","21","707","7.9","5","16","10","0","0","0","0","0","0","0","MFDF","6250083a"
"Pape Matar Sarr","€45.00m","20","Senegal","Tottenham","34","2069","23.0","27","7","0","3","3","6","3","0","0","0","MF","feb5d972"
"Giovani Lo Celso","€16.00m","27","Argentina","Tottenham","22","506","5.6","4","18","6","2","2","4","2","0","0","0","MF","d7553721"
"James Maddison","€70.00m","26","England","Tottenham","28","2135","23.7","26","2","0","4","9","13","4","0","0","0","MF","ee38d9c5"
"Dejan Kulusevski","€55.00m","23","Sweden","Tottenham","36","2762","30.7","31","5","0","8","3","11","8","0","0","0","FWMF","df3cda47"
"Timo Werner","€17.00m","27","Germany","Tottenham","13","809","9.0","10","3","0","2","3","5","2","0","0","0","FW","49fe9070"
"Bryan Gil","€14.00m","22","Spain","Tottenham","11","209","2.3","2","9","13","0","0","0","0","0","0","0","FWMF","7b5ab7f2"
"Manor Solomon","€13.00m","24","Israel","Tottenham","5","199","2.2","2","3","2","0","2","2","0","0","0","0","FW","886f9aac"
"Jamie Donley","€1.50m","18","England","Tottenham","3","3","0.0","0","3","10","0","0","0","0","0","0","0","FW","5e4d9b48"
"Richarlison","€38.00m","26","Brazil","Tottenham","28","1491","16.6","18","10","1","11","4","15","11","0","0","0","FW","fa031b34"
"Dane Scarlett","€1.80m","19","England","Tottenham","4","22","0.2","0","4","4","0","0","0","0","0","0","0","FW","21945a9e"
"Nayef Aguerd","€35.00m","27","Morocco","West Ham","21","1857","20.6","21","0","4","1","0","1","1","0","0","0","DF","288e1e13"
"Kurt Zouma","€25.00m","28","France","West Ham","33","2838","31.5","32","1","1","3","0","3","3","0","0","0","DF","ce4246f5"
"Konstantinos Mavropanos","€20.00m","25","Greece","West Ham","19","1500","16.7","16","3","10","1","0","1","1","0","0","0","DF","00963611"
"Thilo Kehrer","€10.00m","26","Germany","West Ham","4","22","0.2","0","4","14","0","0","0","0","0","0","0","DFMF","51dbeea9"
"Kaelan Casey","€1.00m","18","England","West Ham","1","1","0.0","0","1","7","0","0","0","0","0","0","0","DF","cd4b2c5f"
"Angelo Ogbonna","€700k","35","Italy","West Ham","11","635","7.1","7","4","27","0","0","0","0","0","0","0","DF","74b2cd7e"
"Emerson","€12.00m","24","Brazil","Tottenham","22","1161","12.9","11","11","16","1","0","1","1","0","0","0","DF","df8b52a5"
"Aaron Cresswell","€900k","33","England","West Ham","11","436","4.8","4","7","21","0","0","0","0","0","0","0","DFFW","4f974391"
"Ben Johnson","€8.00m","23","England","West Ham","14","544","6.0","4","10","11","0","0","0","0","0","0","0","DFFW","9319781b"
"Vladimír Coufal","€8.00m","30","Czech Republic","West Ham","36","3132","34.8","36","0","0","0","7","7","0","0","0","0","DF","fdf3cb77"
"Edson Álvarez","€35.00m","25","Mexico","West Ham","31","2377","26.4","28","3","1","1","1","2","1","0","0","0","MF","8b3ab7ad"
"James Ward-Prowse","€30.00m","28","England","West Ham","37","3001","33.3","34","3","0","7","7","14","5","2","2","0","MF","3515d404"
"Lucas Paquetá","€65.00m","25","Brazil","West Ham","31","2622","29.1","31","0","0","4","6","10","2","2","2","0","FWMF","9b6f7fd5"
"Pablo Fornals","€14.00m","27","Spain","West Ham","15","426","4.7","4","11","6","0","0","0","0","0","0","0","MFFW","82927de4"
"George Earthy","€1.00m","18","England","West Ham","3","34","0.4","0","3","6","1","0","1","1","0","0","0","FW","123d2733"
"Saïd Benrahma","€20.00m","27","Algeria","West Ham","13","620","6.9","5","8","7","0","1","1","0","0","1","1","FWMF","5a04fd92"
"Maxwel Cornet","€9.00m","26","Côte d'Ivoire","West Ham","7","112","1.2","1","6","21","1","0","1","1","0","0","0","MFFW","beb391dd"
"Mohammed Kudus","€50.00m","22","Ghana","West Ham","33","2484","27.6","27","6","0","8","6","14","8","0","0","0","FWMF","b62878a5"
"Jarrod Bowen","€50.00m","26","England","West Ham","34","3019","33.5","34","0","0","16","6","22","16","0","0","0","FW","79c84d1c"
"Danny Ings","€8.00m","31","England","West Ham","20","404","4.5","3","17","18","1","0","1","1","0","0","0","FW","07802f7f"
"Michail Antonio","€4.00m","33","Jamaica","West Ham","26","1695","18.8","21","5","0","6","2","8","6","0","0","0","FW","ac05f970"
"Divin Mubama","€1.00m","18","England","West Ham","5","80","0.9","0","5","26","0","0","0","0","0","0","0","FW","92868cb5"
"Santiago Bueno","€8.00m","24","Uruguay","Wolves","12","822","9.1","9","3","18","0","0","0","0","0","0","0","DF","edc98fac"
"Craig Dawson","€2.00m","33","England","Wolves","25","2209","24.5","25","0","2","1","1","2","1","0","0","0","DF","3e9e06cb"
"Rayan Aït-Nouri","€35.00m","22","Algeria","Wolves","33","2329","25.9","29","4","0","2","1","3","2","0","0","0","DFMF","9b398aea"
"Hugo Bueno","€6.00m","20","Spain","Wolves","22","741","8.2","7","15","11","0","0","0","0","0","0","0","DFMF","bfc3b3a0"
"Nélson Semedo","€12.00m","29","Portugal","Wolves","36","3084","34.3","36","0","0","0","1","1","0","0","0","0","DFMF","d04b94db"
"Matt Doherty","€3.00m","31","Republic of Ireland","Wolves","30","1150","12.8","9","21","8","1","0","1","1","0","0","0","DFMF","d557d734"
"Mario Lemina","€10.00m","29","Gabon","Wolves","35","2968","33.0","34","1","0","4","1","5","4","0","0","0","MF","2b471f99"
"Boubacar Traoré","€6.00m","21","Mali","Wolves","24","819","9.1","7","17","9","0","0","0","0","0","0","0","MF","999ceb5f"
"João Gomes","€35.00m","22","Brazil","Wolves","34","2649","29.4","32","2","1","2","1","3","2","0","0","0","MF","8b57ad2c"
"Jean-Ricner Bellegarde","€15.00m","25","France","Wolves","22","958","10.6","10","12","0","2","1","3","2","0","0","0","MFFW","10f0fdd3"
"Tommy Doyle","€10.00m","21","England","Wolves","26","1222","13.6","11","15","6","0","0","0","0","0","0","0","MF","5526deb1"
"Tawanda Chirewa","€500k","19","Zimbabwe","Wolves","8","145","1.6","1","7","15","0","0","0","0","0","0","0","MFFW","34721c11"
"Pedro Neto","€55.00m","23","Portugal","Wolves","20","1516","16.8","18","2","1","2","9","11","2","0","0","0","FWMF","7ba2eaa9"
"Pablo Sarabia","€10.00m","31","Spain","Wolves","30","1745","19.4","20","10","7","4","7","11","2","2","2","0","MFFW","9744ff80"
"Matheus Cunha","€45.00m","24","Brazil","Wolves","32","2440","27.1","29","3","0","12","7","19","11","1","1","0","FWMF","dc62b55d"
"Fábio Silva","€11.00m","21","Portugal","Wolves","8","264","2.9","3","5","9","0","0","0","0","0","0","0","FW","e7aa9d7c"
"Sasa Kalajdzic","€5.00m","26","Austria","Wolves","11","166","1.8","1","10","9","2","0","2","2","0","0","0","FW","15f24fe7"
"Nathan Fraser","€1.00m","18","Republic of Ireland","Wolves","7","186","2.1","1","6","13","0","0","0","0","0","0","0","FW","00b77ecf"
"Leon Chiwome","€1.00m","17","England","Wolves","3","174","1.9","2","1","1","0","0","0","0","0","0","0","FW","a2852b4f"
"Jordan Beyer","€13.00m","23","Germany","Burnley","15","1234","13.7","15","0","0","0","1","1","0","0","0","0","DF","9af1f9ff"
"Ameen Al-Dakhil","€12.00m","21","Belgium","Burnley","13","1056","11.7","12","1","2","1","0","1","1","0","0","0","DF","93e08bce"
"Dara O'Shea","€7.00m","24","Republic of Ireland","Burnley","33","2892","32.1","32","1","1","3","4","7","3","0","0","0","DF","1d042188"
"Hjalmar Ekdal","€7.00m","24","Sweden","Burnley","8","437","4.9","5","3","12","0","0","0","0","0","0","0","DF","3d554589"
"Maxime Estève","€7.00m","21","France","Burnley","16","1309","14.5","15","1","0","0","0","0","0","0","0","0","DF","1a066e69"
"Hannes Delcroix","€4.00m","24","Belgium","Burnley","12","589","6.5","5","7","10","0","0","0","0","0","0","0","DF","b737f944"
"Charlie Taylor","€3.00m","29","England","Burnley","28","2331","25.9","25","3","2","1","1","2","1","0","0","0","DF","cc2d7ad5"
"Lorenz Assignon","€10.00m","23","Togo","Burnley","15","1234","13.7","15","0","0","1","2","3","1","0","0","0","DF","b026bbf6"
"Connor Roberts","€7.00m","27","Wales","Burnley","14","823","9.1","8","6","5","0","1","1","0","0","0","0","DF","24fae784"
"Vitinho","€5.00m","24","Brazil","Burnley","32","2314","25.7","26","6","2","0","2","2","0","0","0","0","DFMF","9295dc1c"
"Sander Berge","€20.00m","25","Norway","Burnley","37","3005","33.4","34","3","0","1","2","3","1","0","0","0","MF","d0b6129f"
"Josh Cullen","€10.00m","27","Republic of Ireland","Burnley","25","2057","22.9","23","2","8","2","3","5","2","0","0","0","MF","f6d7d690"
"Han-Noah Massengo","€4.00m","22","France","Burnley","3","16","0.2","0","3","5","0","0","0","0","0","0","0","MFDF","eba1e557"
"Jack Cork","€800k","34","England","Burnley","4","27","0.3","0","4","18","0","0","0","0","0","0","0","MF","74e12f1e"
"Josh Brownhill","€15.00m","27","England","Burnley","33","2252","25.0","23","10","4","4","2","6","4","0","0","0","MF","47369df8"
"Aaron Ramsey","€15.00m","20","England","Burnley","14","527","5.9","5","9","3","0","0","0","0","0","0","0","MFFW","e1618c22"
"Anass Zaroury","€9.00m","22","Morocco","Burnley","6","152","1.7","1","5","7","0","0","0","0","0","0","0","FWMF","07d65234"
"Mike Trésor","€12.00m","24","Belgium","Burnley","16","420","4.7","3","13","9","0","0","0","0","0","0","0","FWMF","b2a81fc6"
"Jacob Bruun Larsen","€8.00m","24","Denmark","Burnley","32","1249","13.9","16","16","5","6","0","6","5","1","1","0","MFFW","4e204552"
"Wilson Odobert","€10.00m","18","France","Burnley","29","2098","23.3","25","4","4","3","2","5","3","0","0","0","MFFW","35516eac"
"Luca Koleosho","€7.00m","18","Italy","Burnley","15","974","10.8","13","2","0","1","1","2","1","0","0","0","MFFW","fc076f78"
"Benson Manuel","€5.00m","26","Angola","Burnley","8","116","1.3","1","7","13","0","0","0","0","0","0","0","MFFW","d7f99582"
"Nathan Redmond","€5.00m","29","England","Burnley","12","142","1.6","0","12","3","0","0","0","0","0","0","0","FWMF","ab651565"
"Lyle Foster","€13.00m","22","South Africa","Burnley","24","1899","21.1","22","2","0","5","3","8","5","0","0","0","FWMF","f84a807c"
"David Datro Fofana","€12.00m","20","Côte d'Ivoire","Burnley","15","879","9.8","10","5","1","4","1","5","4","0","0","0","FW","e82900ef"
"Zeki Amdouni","€12.00m","22","Switzerland","Burnley","34","1953","21.7","27","7","4","5","1","6","4","1","1","0","FW","2ee5b0c9"
"Michael Obafemi","€2.20m","23","Republic of Ireland","Burnley","2","20","0.2","0","2","4","0","0","0","0","0","0","0","FWMF","caa1a7f0"
"Auston Trusty","€7.00m","24","United States","Sheffield Utd","32","2572","28.6","28","4","6","0","0","0","0","0","0","0","DF","cddf767b"
"Mason Holgate","€5.00m","26","England","Sheffield Utd","10","710","7.9","9","1","2","0","0","0","0","0","0","0","DF","d0042ab9"
"John Egan","€4.00m","30","Republic of Ireland","Sheffield Utd","6","482","5.4","6","0","0","0","0","0","0","0","0","0","DF","debe38a0"
"Jack Robinson","€1.00m","29","England","Sheffield Utd","34","2885","32.1","31","3","0","1","1","2","1","0","0","0","DF","7399c7a8"
"Chris Basham","€300k","35","England","Sheffield Utd","8","321","3.6","3","5","0","0","0","0","0","0","0","0","DFMF","1aa84968"
"Luke Thomas","€6.00m","22","England","Sheffield Utd","12","917","10.2","11","1","4","0","0","0","0","0","0","0","DF","fc027d02"
"Yasser Larouci","€3.00m","22","Algeria","Sheffield Utd","11","531","5.9","6","5","23","0","0","0","0","0","0","0","DF","0ed063d6"
"Max Lowe","€2.50m","26","England","Sheffield Utd","10","503","5.6","4","6","3","0","0","0","0","0","0","0","DFMF","7af88b33"
"Rhys Norrington-Davies","€2.50m","24","Wales","Sheffield Utd","5","110","1.2","2","3","1","0","0","0","0","0","0","0","DF","ca76b087"
"Jayden Bogle","€3.80m","23","England","Sheffield Utd","34","2788","31.0","32","2","1","3","0","3","3","0","0","0","DF","ae5019e6"
"George Baldock","€2.50m","30","Greece","Sheffield Utd","13","969","10.8","11","2","1","0","1","1","0","0","0","0","DF","394854c4"
"Sam Curtis","€150k","17","Republic of Ireland","Sheffield Utd","1","28","0.3","0","1","8","0","0","0","0","0","0","0","DF","7d42865e"
"Gustavo Hamer","€15.00m","26","Netherlands","Sheffield Utd","36","2910","32.3","34","2","0","4","6","10","4","0","0","0","MF","eebacc07"
"Tom Davies","€5.00m","25","England","Sheffield Utd","9","221","2.5","2","7","1","0","0","0","0","0","0","0","MF","9228b07c"
"Andre Brooks","€2.50m","19","England","Sheffield Utd","20","938","10.4","12","8","11","0","0","0","0","0","0","0","MFDF","5f346071"
"Oliver Norwood","€1.00m","32","Northern Ireland","Sheffield Utd","27","1440","16.0","16","11","9","1","0","1","0","1","1","0","MF","43439614"
"Ben Osborn","€1.00m","28","England","Sheffield Utd","24","1367","15.2","14","10","5","0","2","2","0","0","0","0","DFMF","79bc4c45"
"John Fleck","€900k","31","Scotland","Sheffield Utd","4","92","1.0","1","3","5","0","0","0","0","0","0","0","MFDF","b63e789d"
"Oliver Arblaster","€450k","19","England","Sheffield Utd","12","943","10.5","11","1","2","0","0","0","0","0","0","0","MF","afe1a491"
"Sydie Peck","€200k","18","England","Sheffield Utd","1","10","0.1","0","1","1","0","0","0","0","0","0","0","MF","767d9605"
"Bénie Traoré","€4.00m","20","Côte d'Ivoire","Sheffield Utd","8","387","4.3","3","5","11","0","0","0","0","0","0","0","FWMF","77816c91"
"Rhian Brewster","€3.00m","23","England","Sheffield Utd","13","346","3.8","3","10","1","0","0","0","0","0","0","0","FWMF","30e81a88"
"William Osula","€3.00m","19","Denmark","Sheffield Utd","21","786","8.7","9","12","9","0","0","0","0","0","0","0","FW","7b355808"
"Daniel Jebbison","€1.00m","19","England","Sheffield Utd","1","21","0.2","0","1","0","0","0","0","0","0","0","0","FW","03edb878"
"Antwoine Hackford","€500k","19","England","Sheffield Utd","2","13","0.1","0","2","0","0","0","0","0","0","0","0","FW","a7588cdc"
"Teden Mengi","€12.00m","21","England","Luton Town","30","2469","27.4","28","2","3","1","0","1","1","0","0","0","DF","91748070"
"Gabriel Osho","€3.00m","24","Nigeria","Luton Town","21","1846","20.5","21","0","1","2","0","2","2","0","0","0","DF","cd889153"
"Tom Lockyer","€2.50m","28","Wales","Luton Town","14","1169","13.0","14","0","0","1","1","2","1","0","0","0","DF","37118440"
"Reece Burke","€1.80m","26","England","Luton Town","22","1660","18.4","20","2","3","0","4","4","0","0","0","0","DF","a681b7b7"
"Amari'i Bell","€2.50m","29","Jamaica","Luton Town","21","1720","19.1","21","0","0","0","0","0","0","0","0","0","DF","399e9474"
"Issa Kaboré","€10.00m","22","Burkina Faso","Luton Town","24","1729","19.2","21","3","4","0","2","2","0","0","0","0","DF","c066d1a5"
"Daiki Hashioka","€2.00m","24","Japan","Luton Town","10","595","6.6","6","4","3","0","0","0","0","0","0","0","DF","10cb48b7"
"Marvelous Nakamba","€5.00m","29","Zimbabwe","Luton Town","13","1130","12.6","13","0","0","0","0","0","0","0","0","0","MF","de5b5570"
"Pelly Ruddock Mpanzu","€1.50m","30","DR Congo","Luton Town","27","1101","12.2","11","16","11","0","0","0","0","0","0","0","MF","a9b1c319"
"Albert Sambi Lokonga","€15.00m","23","Belgium","Luton Town","17","1303","14.5","16","1","0","1","3","4","1","0","0","0","MF","1b4f1169"
"Ross Barkley","€8.00m","29","England","Luton Town","32","2618","29.1","30","2","0","5","4","9","5","0","0","0","MF","3a24769f"
"Jordan Clark","€1.00m","29","England","Luton Town","23","1304","14.5","14","9","4","1","1","2","1","0","0","0","MF","7c5fa6cf"
"Luke Berry","€400k","31","England","Luton Town","17","323","3.6","2","15","16","2","1","3","2","0","0","0","MFDF","2aaadf33"
"Alfie Doughty","€10.00m","23","England","Luton Town","37","2925","32.5","34","3","0","2","8","10","2","0","0","0","DF","bf33b257"
"Fred Onyedinma","€500k","26","England","Luton Town","8","407","4.5","4","4","1","0","0","0","0","0","0","0","DFMF","387d06b2"
"Zack Nelson","€100k","18","England","Luton Town","2","7","0.1","0","2","14","0","0","0","0","0","0","0","MFDF","de0abf23"
"Chiedozie Ogbene","€8.00m","26","Republic of Ireland","Luton Town","30","1995","22.2","20","10","0","4","1","5","4","0","0","0","MFDF","788c0277"
"Tahith Chong","€6.00m","23","Netherlands","Luton Town","33","1982","22.0","20","13","5","4","0","4","4","0","0","0","MFFW","2696b6a9"
"Andros Townsend","€1.80m","32","England","Luton Town","27","1210","13.4","14","13","3","1","3","4","1","0","0","0","MFFW","b28bbd58"
"Carlton Morris","€13.00m","27","England","Luton Town","38","2862","31.8","32","6","0","11","4","15","6","5","5","0","FWMF","2da834f1"
"Elijah Adebayo","€12.00m","25","England","Luton Town","27","1419","15.8","16","11","0","10","0","10","10","0","0","0","FW","0480ebc7"
"Jacob Brown","€4.00m","25","Scotland","Luton Town","19","1019","11.3","12","7","2","2","0","2","2","0","0","0","MFFW","ca18c8f1"
"Cauley Woodrow","€1.00m","28","England","Luton Town","24","427","4.7","2","22","8","1","1","2","1","0","0","0","FWMF","d3085b49"
